border_size=1
usage=map

Gg          , Gg          , Gg          , Gg          , Gg          , Gg          , Gg          , Gg          , Gg          , Gg          , Ww          , Gg          , Gg          , Gg          , Gg          , Gg          , Gg          , Gg          , Gg          , Gg          , Gg          , Gg          , Gg          , Gg          , Gg          , Gg          , Gg          , Gg          , Gg          , Gg          , Gg          , Gg          , Ww          
Gg          , Gg          , Ch          , Gg          , Gg          , Gg          , Ch          , Gg          , Wwf         , Ww          , Gg          , Gg          , Gg          , Gg          , Gg          , Ch          , 1 Kh        , Ch          , Gg          , Gg          , Gg          , Gg          , Ss          , Gg          , Gg          , Gg          , Gg          , Gg          , Gg          , Gg          , Ww          , Ww          , Gg          
Gg          , Kh          , Gs^Vht      , Gg          , Gg          , Gg          , Wwf         , Wwf         , Gg          , Gg          , Gg          , Gg          , Gg          , Gg          , Gg          , Ch          , Ch          , Ch          , Gg          , Gg          , Gg          , Ww          , Ss^Vm       , Ww          , Gg          , Gg          , Gg          , Gg          , Wwf         , Ww          , Gg          , Gg          , Gg          
Gg          , Ch          , Gg          , Gg          , Gg          , Gg          , Ww          , Gg          , Gg          , Gg          , Gg          , Gg          , Gg          , Gg          , Uu^Uf       , Gg          , Gs^Vht      , Gg          , Gg          , Gg          , Gg          , Ss          , Ww          , Ss          , Gg          , Gg          , Wwf         , Wwf         , Gg          , Gg          , Gg          , Gg          , Gg          
Gg          , Gg          , Gg          , Ch          , Wwf         , Ww          , Gg          , Hh          , Gs^Fp       , Gg          , Gg          , Gg          , Gg          , Gs^Fp       , Hh          , Gg          , Gg          , Gg          , Gg          , Gg          , Hh          , Gg          , Gg          , Gg          , Gg          , Gg          , Wwf         , Hh          , Uu^Uf       , Gg          , Gg          , Gg          , Gg          
Gg          , Gg          , Wwf         , Wwf         , Gg          , Gg          , Aa^Fpa      , Uu^Uf       , Gg          , Gg          , Gg          , Gg          , Gg          , Gg          , Gg          , Gg          , Gg          , Gg          , Gs^Fp       , Gs^Fp       , Gs^Fp       , Gg          , Gg          , Gg          , Gg          , Ww          , Hh          , Aa^Fpa      , Gg          , Gg          , Gg          , Gg          , Gg          
Ww          , Ww          , Gg          , Gg          , Gg          , Gg          , Gg          , Hh          , Gg          , Gg          , Aa^Fpa      , Hh          , Gg          , Gg          , Gg          , Gg          , Gg          , Gg          , Gg          , Ha          , Gg          , Gg          , Gg          , Gg          , Wwf         , Ww          , Gg          , Gg          , Gs^Vht      , Gg          , Gg          , Gg          , Gg          
Gg          , Gg          , Gg          , Gg          , Hh          , Gg          , Gg          , Gg          , Gg          , Hh          , Uu^Uf       , Gs^Fp       , Gg          , Gg          , Gg          , Gg          , Gg          , Gg          , Gg          , Gg          , Gg          , Gg          , Aa^Fpa      , Gg          , Wwf         , Gg          , Gg          , Gg          , Gg          , Gg          , Gg          , Gg          , Gg          
Gg          , Gg          , Gg          , Gs^Fp       , Hh          , Aa^Fpa      , Gg          , Gg          , Gg          , Gs^Fp       , Gg          , Gg          , Gg          , Gg          , Gg          , Gg          , Gs^Fp       , Gs^Fp       , Gg          , Gg          , Gs^Fp       , Hh          , Uu^Uf       , Wwf         , Hh          , Gg          , Gg          , Gg          , Ha          , Gg          , Gg          , Gg          , Gg          
Ww          , Ww          , Wwf         , Gg          , Gs^Fp       , Uu^Uf       , Gg          , Gg          , Gg          , Gg          , Gg          , Gg          , Gg          , Gg          , Gg          , Ha          , Hh          , Uu^Uf       , Wwf         , Gg          , Wwf         , Hh          , Ms          , Ww          , Gs^Fp       , Gg          , Gg          , Gs^Fp       , Uu^Uf       , Gs^Fp       , Gg          , Gg          , Gg          
Gg          , Gg          , Aa^Fpa      , Wwf         , Wwf         , Wwf         , Ww          , Gg          , Gg          , Gg          , Gs^Fp       , Uu^Uf       , Gs^Fp       , Gg          , Gg          , Gs^Fp       , Ww          , Ww          , Gg          , Wwf         , Gg          , Ww          , Ai          , Ai          , Hh          , Gg          , Gg          , Hh          , Aa^Fpa      , Hh          , Gg          , Gg          , Gg          
Gg          , Gg          , Uu^Uf       , Hh          , Gs^Fp       , Uu^Uf       , Gg          , Wwf         , Wwf         , Wwf         , Ai          , Ms          , Ww          , Hh          , Wwf         , Wwf         , Gg          , Gg          , Gs^Vht      , Gg          , Gg          , Gg          , Ww          , Aa^Fpa      , Gg          , Gg          , Gg          , Gg          , Gg          , Gg          , Gg          , Gg          , Gg          
Gg          , Gg          , Gg          , Gs^Fp       , Hh          , Gg          , Gs^Vht      , Gg          , Hh          , Aa^Fpa      , Ww          , Ai          , Gg          , Wwf         , Gg          , Gg          , Gs^Fp       , Ha          , Aa^Fpa      , Gs^Fp       , Gg          , Gg          , Ww          , Ww          , Gg          , Gg          , Gg          , Gg          , Gs^Vht      , Gg          , Gg          , Gg          , Gg          
Gg          , Gg          , Gg          , Gg          , Gg          , Gg          , Gg          , Gg          , Gg          , Gs^Fp       , Ww          , Gg          , Gg          , Gg          , Gs^Fp       , Uu^Uf       , Ww          , Ms          , Gs^Fp       , Hh          , Gg          , Gg          , Ww          , Gs^Fp       , Ha          , Gg          , Gg          , Gg          , Gg          , Gg          , Gg          , Gg          , Gg          
Gg          , Gg          , Gg          , Gg          , Gg          , Gg          , Gg          , Gg          , Gg          , Gg          , Ww          , Gg          , Gg          , Hh          , Aa^Fpa      , Ms          , Gs^Fp       , Uu^Uf       , Gg          , Gg          , Gg          , Gg          , Ai          , Ai          , Ww          , Gg          , Gs^Fp       , Gg          , Uu^Uf       , Gg          , Gg          , Gg          , Gg          
Gg          , Gg          , Gg          , Gg          , Hh          , Aa^Fpa      , Hh          , Gg          , Gg          , Ww          , Ww          , Gg          , Gg          , Gs^Fp       , Gs^Vht      , Ha          , Gg          , Gg          , Gg          , Gg          , Wwf         , Wwf         , Hh          , Ms          , Aa^Fpa      , Wwf         , Wwf         , Hh          , Aa^Fpa      , Gg          , Gg          , Gg          , Gg          
Gg          , Gg          , Gg          , Gg          , Gs^Fp       , Uu^Uf       , Gs^Fp       , Gg          , Gg          , Gg          , Ww          , Gg          , Gg          , Gg          , Gg          , Gg          , Wwf         , Gg          , Ww          , Wwf         , Gg          , Gg          , Gs^Fp       , Uu^Uf       , Gs^Fp       , Hh          , Gg          , Wwf         , Ww          , Gg          , Wwf         , Gg          , Gg          
Gg          , Gg          , Gg          , Gg          , Gg          , Ha          , Gg          , Gg          , Ha          , Gs^Fp       , Ai          , Gg          , Ww          , Ww          , Wwf         , Wwf         , Gs^Fp       , Ww          , Hh          , Gs^Fp       , Gg          , Gg          , Gg          , Gg          , Gg          , Gg          , Gs^Fp       , Gg          , Gg          , Wwf         , Gg          , Wwf         , Ww          
Gg          , Gg          , Gg          , Gg          , Gs^Vht      , Gg          , Gg          , Gg          , Gs^Fp       , Ai          , Ms          , Ww          , Aa^Fpa      , Gg          , Gg          , Gg          , Uu^Uf       , Ww          , Aa^Fpa      , Uu^Uf       , Gg          , Gg          , Gs^Vht      , Gg          , Gg          , Gg          , Hh          , Uu^Uf       , Hh          , Gg          , Gg          , Gg          , Gg          
Gg          , Gg          , Gg          , Gg          , Gg          , Gg          , Gg          , Gg          , Ww          , Ww          , Uu^Uf       , Hh          , Gg          , Gg          , Gg          , Gg          , Gg          , Hh          , Gg          , Gg          , Gg          , Gg          , Gg          , Gg          , Gg          , Gg          , Gg          , Aa^Fpa      , Gs^Vht      , Gg          , Gg          , Gg          , Gg          
Gg          , Gg          , Gg          , Gg          , Hh          , Gs^Fp       , Gg          , Gg          , Wwf         , Gs^Fp       , Hh          , Gg          , Gs^Vht      , Gg          , Aa^Fpa      , Gg          , Gg          , Gg          , Gg          , Gg          , Gg          , Gg          , Hh          , Gg          , Gg          , Gg          , Gg          , Gg          , Gg          , Gg          , Gg          , Gg          , Ww          
Gg          , Gg          , Gg          , Uu^Uf       , Aa^Fpa      , Gg          , Wwf         , Wwf         , Gg          , Gg          , Gg          , Gg          , Gg          , Gg          , Uu^Uf       , Hh          , Gg          , Gg          , Gg          , Gg          , Gg          , Aa^Fpa      , Uu^Uf       , Gs^Fp       , Gg          , Gg          , Gg          , Gg          , Gg          , Gg          , Wwf         , Ww          , Gg          
Gg          , Gg          , Gg          , Hh          , Gg          , Wwf         , Hh          , Gg          , Gg          , Gg          , Ww          , Gg          , Gg          , Gg          , Gg          , Gg          , Gg          , Gg          , Gg          , Gg          , Gg          , Gg          , Gg          , Hh          , Gg          , Gg          , Gg          , Gg          , Gg          , Wwf         , Ch          , Gg          , Gg          
Gg          , Gg          , Gg          , Gg          , Ww          , Ww          , Aa^Fpa      , Gs^Fp       , Gg          , Ss          , Ss^Vm       , Ss          , Gg          , Gg          , Gg          , Gg          , Ch          , Gg          , Gg          , Gg          , Gg          , Gg          , Gg          , Gg          , Gg          , Gg          , Gg          , Gg          , Ww          , Wwf         , Gg          , Gg          , Gg          
Gg          , Gg          , Gg          , Gg          , Wwf         , Hh          , Gg          , Gg          , Gg          , Ww          , Ss          , Ww          , Gg          , Gg          , Gg          , Ch          , 2 Kh        , Ch          , Gg          , Gg          , Hh          , Gs^Fp       , Aa^Fpa      , Gg          , Gg          , Gg          , Wwf         , Ww          , Gg          , Gg          , Gs^Vht      , Ch          , Gg          
Gg          , Gg          , Wwf         , Wwf         , Gg          , Gg          , Gg          , Gg          , Gg          , Gg          , Gg          , Gg          , Gg          , Gg          , Gg          , Ch          , Gs^Vht      , Ch          , Gg          , Gg          , Gs^Fp       , Hh          , Gg          , Gg          , Wwf         , Wwf         , Ch          , Gg          , Gg          , Gg          , Ch          , Kh          , Gg          
Ww          , Wwf         , Gg          , Gg          , Gg          , Gg          , Gg          , Gg          , Gg          , Gg          , Gg          , Gg          , Gg          , Gg          , Gg          , Gg          , Gg          , Gg          , Gg          , Gg          , Gg          , Gg          , Ww          , Ww          , Gg          , Gg          , Gg          , Gg          , Gg          , Gg          , Gg          , Gg          , Gg          
